PFO	Poecilia formosa (Amazon molly)
SRH	Sinocyclocheilus rhinocerous (Horned golden-line barbel)
PPY	Pongo abelii (Sumatran orangutan)
NFU	Nothobranchius furzeri (Turquoise killifish)
CJA	Callithrix jacchus (White-tufted-ear marmoset)
PTR	Pan troglodytes (Chimpanzee)
UPA	Urocitellus parryii (Arctic ground squirrel)
PSM	Prolemur simus (Greater bamboo lemur)
MEU	Notamacropus eugenii (Wallaby)
LCA	Lates calcarifer (Barramundi perch)
OSU	Otus sunia (Oriental scops-owl)
PLO	Panthera leo (Lion)
MPU	Mustela putorius furo (Ferret)
DAR	Danio rerio (Zebrafish)
CPO	Cavia porcellus (Guinea Pig)
MMD	Myripristis murdjan (Pinecone soldierfish)
PCA	Procavia capensis (Hyrax)
LBE	Labrus bergylta (Ballan wrasse)
XCO	Xiphophorus couchianus (Monterrey platyfish)
VVU	Vulpes vulpes (Red fox)
DLA	Dicentrarchus labrax (European seabass)
OSI	Oryzias sinensis (Chinese medaka)
ORL	Oryzias latipes (Japanese medaka HSOK)
GFO	Geospiza fortis (Medium ground-finch)
BSL	Betta splendens (Siamese fighting fish)
SFA	Salarias fasciatus (Jewelled blenny)
ACD	Anser cygnoides (Swan goose)
SSC	Sus scrofa (Pig - Pietrain)
CPI	Chrysolophus pictus (Golden pheasant)
XMA	Xiphophorus maculatus (Platyfish)
TRU	Takifugu rubripes (Fugu)
MUG	Meriones unguiculatus (Mongolian gerbil)
CAB	Chelonoidis abingdonii (Abingdon island giant tortoise)
MGP_PahariEiJ_	Mus pahari (Shrew mouse)
MGP_FVBNJ_	Mus musculus (Mouse FVB/NJ)
EBU	Eptatretus burgeri (Hagfish)
PRN	Parambassis ranga (Indian glassy fish)
DNV	Dromaius novaehollandiae (Emu)
SHB	Strigops habroptila (Kakapo)
KMA	Kryptolebias marmoratus (Mangrove rivulus)
GAG	Gopherus agassizii (Agassiz's desert tortoise)
SVL	Sciurus vulgaris (Eurasian red squirrel)
BTA	Bos taurus (Cow)
RRO	Rhinopithecus roxellana (Golden snub-nosed monkey)
CLA	Chinchilla lanigera (Long-tailed chinchilla)
HHU	Hucho hucho (Huchen)
NME	Numida meleagris (Helmeted guineafowl)
CPG	Calidris pygmaea (Spoon-billed sandpiper)
NPE	Nothoprocta perdicaria (Chilean tinamou)
MOD	Monodelphis domestica (Opossum)
SCU	Struthio camelus australis (African ostrich)
MLE	Mandrillus leucophaeus (Drill)
CGR	Cricetulus griseus (Chinese hamster CHOK1GS)
PME	Poecilia mexicana (Shortfin molly)
BGR	Bos grunniens (Domestic yak)
CGO	Cottoperca gobio (Channel bull blenny)
CAR	Carassius auratus (Goldfish)
MZE	Maylandia zebra (Zebra mbuna)
CHA	Scleropages formosus (Asian bonytongue)
SLU	Sander lucioperca (Pike-perch)
PSN	Phocoena sinus (Vaquita)
PRE	Poecilia reticulata (Guppy)
ACU	Athene cunicularia (Burrowing owl)
MOC	Microtus ochrogaster (Prairie vole)
PAN	Papio anubis (Olive baboon)
JHY	Junco hyemalis (Dark-eyed junco)
TMT	Terrapene carolina triunguis (Three-toed box turtle)
CSE	Cynoglossus semilaevis (Tongue sole)
HCO	Hippocampus comes (Tiger tail seahorse)
PST	Pavo cristatus (Indian peafowl)
LAC	Latimeria chalumnae (Coelacanth)
OCU	Oryctolagus cuniculus (Rabbit)
STU	Salmo trutta (Brown trout)
MGP_AKRJ_	Mus musculus (Mouse AKR/J)
SHA	Sarcophilus harrisii (Tasmanian devil)
EGO	Erythrura gouldiae (Gouldian finch)
TSY	Carlito syrichta (Tarsier)
APE	Amphiprion percula (Orange clownfish)
CMM	Cairina moschata domestica (Muscovy Duck (domestic type))
ZCA	Zalophus californianus (California sea lion)
ETE	Echinops telfairi (Lesser hedgehog tenrec)
PCO	Propithecus coquereli (Coquerel's sifaka)
ECR	Erpetoichthys calabaricus (Reedfish)
ELU	Esox lucius (Northern pike)
NBR	Neolamprologus brichardi (Lyretail cichlid)
ENL	Echeneis naucrates (Live sharksucker)
SPA	Stegastes partitus (Bicolor damselfish)
PCL	Phasianus colchicus (Ring-necked pheasant)
MAL	Monopterus albus (Swamp eel)
PEM	Peromyscus maniculatus bairdii (Northern American deer mouse)
SBO	Saimiri boliviensis boliviensis (Bolivian squirrel monkey)
CDR	Camelus dromedarius (Arabian camel)
SAN	Sinocyclocheilus anshuiensis (Blind barbel)
GAL	Gallus gallus (Chicken (maternal Broiler))
GMO	Gadus morhua (Atlantic cod)
AZO	Anas zonorhyncha (Eastern spot-billed duck)
MGA	Meleagris gallopavo (Turkey)
MGP_AJ_	Mus musculus (Mouse A/J)
LCR	Larimichthys crocea (Large yellow croaker)
CGR	Cricetulus griseus (Chinese hamster PICR)
DCD	Denticeps clupeoides (Denticle herring)
SOC	Strix occidentalis caurina (Northern spotted owl)
BIX	Bos indicus x Bos taurus (Hybrid - Bos Taurus)
MGP_CASTEiJ_	Mus musculus castaneus (Mouse CAST/EiJ)
DOR	Dipodomys ordii (Kangaroo rat)
CPV	Camarhynchus parvulus (Small tree finch)
MGP_C3HHeJ_	Mus musculus (Mouse C3H/HeJ)
CAT	Cercocebus atys (Sooty mangabey)
LCN	Lynx canadensis (Canada lynx)
RBI	Rhinopithecus bieti (Black snub-nosed monkey)
TGE	Theropithecus gelada (Gelada)
PMA	Petromyzon marinus (Lamprey)
ARW	Apteryx rowi (Okarito brown kiwi)
MGP_DBA2J_	Mus musculus (Mouse DBA/2J)
MFA	Macaca fascicularis (Crab-eating macaque)
ACC	Aquila chrysaetos chrysaetos (Golden eagle)
CGR	Cricetulus griseus (Chinese hamster CriGri)
OME	Oryzias melastigma (Indian medaka)
ACI	Amphilophus citrinellus (Midas cichlid)
UTT	Ursus thibetanus thibetanus (Asiatic black bear)
ODE	Octodon degus (Degu)
PVI	Pogona vitticeps (Central bearded dragon)
OAN	Ornithorhynchus anatinus (Platypus)
NNA	Naja naja (Indian cobra)
GWI	Gouania willdenowi (Blunt-snouted clingfish)
DLE	Delphinapterus leucas (Beluga whale)
APL	Anas platyrhynchos platyrhynchos (Duck)
GAC	Gasterosteus aculeatus (Stickleback)
ACL	Astatotilapia calliptera (Eastern happy)
LAF	Loxodonta africana (Elephant)
FHE	Fundulus heteroclitus (Mummichog)
MGP_BALBcJ_	Mus musculus (Mouse BALB/cJ)
MMO	Mola mola (Ocean sunfish)
NGA	Nannospalax galili (Upper Galilee mountains blind mole rat)
HOM	Homo sapiens (Human)
RNO	Rattus norvegicus (Rat)
CMU	Corvus moneduloides (New Caledonian crow)
PTI	Panthera tigris altaica (Tiger)
SSA	Salmo salar (Atlantic salmon)
MGP_CBAJ_	Mus musculus (Mouse CBA/J)
ACA	Anolis carolinensis (Green anole)
MMN	Monodon monoceros (Narwhal)
OGA	Otolemur garnettii (Bushbaby)
CHY	Cervus hanglu yarkandensis (Yarkand deer)
PKI	Paramormyrops kingsleyae (Paramormyrops kingsleyae)
CHO	Choloepus hoffmanni (Sloth)
CAF	Canis lupus familiaris (Dog)
SDU	Seriola dumerili (Greater amberjack)
CAP	Cavia aperea (Brazilian guinea pig)
SDA	Spermophilus dauricus (Daurian ground squirrel)
OPR	Ochotona princeps (Pika)
MUS	Mus musculus (Mouse)
MSI	Mus spicilegus (Steppe mouse)
FCA	Felis catus (Cat)
FTI	Falco tinnunculus (Common kestrel)
MAU	Mesocricetus auratus (Golden Hamster)
JJA	Jaculus jaculus (Lesser Egyptian jerboa)
ZAL	Zonotrichia albicollis (White-throated sparrow)
CHI	Capra hircus (Goat)
UAM	Ursus americanus (American black bear)
CCR	Cyprinus carpio carpio (Common carp)
MMS	Moschus moschiferus (Siberian musk deer)
BOB	Bubo bubo (Eurasian eagle-owl)
PMG	Periophthalmus magnuspinnatus (Periophthalmus magnuspinnatus)
RFE	Rhinolophus ferrumequinum (Greater horseshoe bat)
PPA	Pan paniscus (Bonobo)
AOC	Amphiprion ocellaris (Clown anemonefish)
LLT	Laticauda laticaudata (Blue-ringed sea krait)
UMA	Ursus maritimus (Polar bear)
PNA	Pygocentrus nattereri (Red-bellied piranha)
VPA	Vicugna pacos (Alpaca)
CPU	Calidris pugnax (Ruff)
CLM	Cyclopterus lumpus (Lumpfish)
PMR	Podarcis muralis (Common wall lizard)
ABR	Anser brachyrhynchus (Pink-footed goose)
MMM	Marmota marmota marmota (Alpine marmot)
129	Mus musculus (Mouse 129S1/SvImJ)
HBU	Haplochromis burtoni (Burton's mouthbrooder)
IPU	Ictalurus punctatus (Channel catfish)
SMR	Salvator merianae (Argentine black and white tegu)
WSB	Mus musculus domesticus (Mouse WSB/EiJ)
C57	Mus musculus (Mouse C57BL/6NJ)
MAM	Mastacembelus armatus (Zig-zag eel)
NOD	Mus musculus (Mouse NOD/ShiLtJ)
TBE	Tupaia belangeri (Tree Shrew)
BBB	Bison bison bison (American bison)
OAR	Ovis aries (Sheep)
NVI	Neovison vison (American mink)
TNI	Tetraodon nigroviridis (Tetraodon)
MIC	Microcebus murinus (Mouse Lemur)
SOR	Sphaeramia orbicularis (Orbiculate cardinalfish)
ECA	Equus caballus (Horse)
OTS	Oncorhynchus tshawytscha (Chinook salmon)
MGP_CAROLI_	Mus caroli (Ryukyu mouse)
MVI	Manacus vitellinus (Golden-collared manakin)
ATE	Anabas testudineus (Climbing perch)
CRF	Cyanoderma ruficeps (Rufous-capped babbler)
CPR	Crocodylus porosus (Australian saltwater crocodile)
ACO	Amazona collaria (Yellow-billed parrot)
AHA	Apteryx haastii (Great spotted kiwi)
PVA	Pteropus vampyrus (Megabat)
SPR	Mus spretus (Algerian mouse)
CHA	Clupea harengus (Atlantic herring)
NLE	Nomascus leucogenys (Gibbon)
MCS	Malurus cyaneus samueli (Superb fairywren)
MLU	Myotis lucifugus (Microbat)
CUS	Catharus ustulatus (Swainson's thrush)
PNY	Pundamilia nyererei (Makobe Island cichlid)
MNE	Macaca nemestrina (Pig-tailed macaque)
CMI	Callorhinchus milii (Elephant shark)
GEV	Gopherus evgoodei (Goodes thornscrub tortoise)
PCT	Physeter catodon (Sperm whale)
BMU	Bos mutus (Wild yak)
CCE	Cyanistes caeruleus (Blue tit)
PLA	Poecilia latipinna (Sailfin molly)
OKI	Oncorhynchus kisutch (Coho salmon)
APO	Acanthochromis polyacanthus (Spiny chromis)
EEU	Erinaceus europaeus (Hedgehog)
SPU	Sphenodon punctatus (Tuatara)
NML	Neogobius melanostomus (Round goby)
PPR	Panthera pardus (Leopard)
SMA	Scophthalmus maximus (Turbot)
TGU	Taeniopygia guttata (Zebra finch)
PSI	Pelodiscus sinensis (Chinese softshell turtle)
CPI	Chrysemys picta bellii (Painted turtle)
EAS	Equus asinus asinus (Donkey)
CCA	Cebus capucinus imitator (Capuchin)
GAF	Gambusia affinis (Western mosquitofish)
CSA	Chlorocebus sabaeus (Vervet-AGM)
ANI	Accipiter nisus (Eurasian sparrowhawk)
FDA	Fukomys damarensis (Damara mole rat)
OAB	Oreochromis aureus (Blue tilapia)
LPJ	Mus musculus (Mouse LP/J)
PTX	Pseudonaja textilis (Eastern brown snake)
FAL	Ficedula albicollis (Collared flycatcher)
CAN	Colobus angolensis palliatus (Angola colobus)
PMJ	Parus major (Great Tit)
LCO	Lepidothrix coronata (Blue-crowned manakin)
LOC	Lepisosteus oculatus (Spotted gar)
CIN	Ciona intestinalis
OJA	Oryzias javanicus (Javanese ricefish)
VKK	Varanus komodoensis (Komodo dragon)
SCA	Serinus canaria (Common canary)
SSU	Suricata suricatta (Meerkat)
EEE	Electrophorus electricus (Electric eel)
ANA	Aotus nancymaae (Ma's night monkey)
PCE	Pelusios castaneus (West African mud turtle)
LSD	Lonchura striata domestica (Bengalese finch)
AOW	Apteryx owenii (Little spotted kiwi)
TTR	Tursiops truncatus (Dolphin)
CSA	Ciona savignyi
ZLM	Zosterops lateralis melanops (Silver-eye)
SLD	Seriola lalandi dorsalis (Yellowtail amberjack)
CCN	Castor canadensis (American beaver)
PTE	Piliocolobus tephrosceles (Ugandan red Colobus)
BJA	Buteo japonicus (Eastern buzzard)
AME	Ailuropoda melanoleuca (Giant panda)
GGO	Gorilla gorilla gorilla (Gorilla)
STO	Ictidomys tridecemlineatus (Squirrel)
SAU	Sparus aurata (Gilthead seabream)
CSR	Chelydra serpentina (Common snapping turtle)
CJP	Coturnix japonica (Japanese quail)
MUN	Melopsittacus undulatus (Budgerigar)
ONI	Oreochromis niloticus (Nile tilapia)
HGL	Heterocephalus glaber (Naked mole-rat)
NSU	Notechis scutatus (Mainland tiger snake)
SAR	Sorex araneus (Shrew)
PWK	Mus musculus musculus (Mouse PWK/PhJ)
LLE	Leptobrachium leishanense (Leishan spiny toad)
BMS	Balaenoptera musculus (Blue whale)
PCI	Phascolarctos cinereus (Koala)
OMY	Oncorhynchus mykiss (Rainbow trout)
MMU	Macaca mulatta (Macaque)
DNO	Dasypus novemcinctus (Armadillo)
CVA	Cyprinodon variegatus (Sheepshead minnow)
SGR	Sinocyclocheilus grahami (Golden-line barbel)
AMX	Astyanax mexicanus (Mexican tetra)
NZO	Mus musculus (Mouse NZO/HlLtJ)
VUR	Vombatus ursinus (Common wombat)
CWA	Catagonus wagneri (Chacoan peccary)
XET	Xenopus tropicalis (Tropical clawed frog)
